NO ./assets/wall2.xpm
SO ./assets/door_open.xpm
WE ./assets/floor.xpm
EA ./assets/wall.xpm

F 220,100,0
C 225,30,0

1111111111
1N20002001
1211110111
10020021
11111111