NO ./assets/wall2.xpm
SO ./assets/door_open.xpm
WE ./assets/floor.xpm

    
F      120,200,0  
EA ./assets/wall.xpm
    

C 0,30,220
111111             111111
100001             100001
100001             100001
100001             100001
100001             100001
1000011111111111111100001
10E0000000002000000000001
1000011111111111111100001
100001             100001
100001             100001
100001             100001
100001             100001
111111             111111