NO ./assets/wall2.xpm
SO ./assets/door_open.xpm
WE ./assets/floor.xpm

    
F      120,200,0  
EA ./assets/wall.xpm
    

C 0,30,220
1111111111111111111111
1E00000002000000000001
1011111111111111111101
101                101
121                121
1011111111111111111101
1000000002000000000001
1111111111111111111111